111111111111111111111111111111
11010000001000001011010101E111
100100000000000T00000000010001
100111111111111111100000010C01
100000010000000000000000010C01
1001C0010000000000000000010001
100100010000011111111000010001
100100000T00010T0000000000P001
100101110000010001000000000001
10T100110000010001000000111111
1001111100000100010C011110T001
1000C00000T00000010000000000C1
111111111111111111111111111111