111111111111111
1000100000110C1
10C010011111001
1100110CEC01101
11000P0C1100C01
10C000000000001
111111111111111