111111111111111
1000100000110C1
10C010011111001
11001100E001101
11000P001100C01
10C000000000001
111111111111111