111111111111111111111111111111111111111111111111111111111111111111
1P0000000000000000000000000000000000000000000000000000000000000001
100000111110000111111000000000000111110000111111000000000000000001
1C000000C00000000000C000000000000C00000000000C00000000000000000011
100000011100011101110000000000011100011101110000000000000000000001
1C00000000000000000000000C00000000000000000000000C0000000000000001
100111100011111000111110001001111100011111000111110001001111100001
100000000000000000000000T00001000000000000000000000000000001000001
1C00000C0000000C00000000000101000000C0000000C00000000000E010000011
100000000000000000000000000001000000000000000000000000000001000001
111111111111111111111111111111111111111111111111111111111111111111