111111111111111111111111111
1EC000000000011111100000001
1001100000000T0000100000001
100011111110001111111110001
100000000010001000000000001
100011110010001000100000001
1000001000000T00001000000P1
111111111111111111111111111
