111111111111111111111111111
10T000000000000000000000001
100000111110000000000000001
1C0000C00000000E01000111111
1000000000000000001000P10T1
111111111111111111111111111